NO textures/north.xpm
WE textures/west.xpm
F 25,100,255
C 0,0,0
EA textures/east.xpm
SO textures/south.xpm


111  111
1111
11111111
10000001
1010N0011
10100011
10100011
10100011
10100011
10100011
10100011
10100011
10100011
111111111
1111