NO textures/north.xpm
SO textures/south.xpm
WE textures/west.xpm
EA textures/east.xpm
F 128,128,128
C 98,47,34

1111111111111111111111
1010010000100001110001
1000111010001011100001
1010000010110000001001
11111111110111111001111111111111
1111111111111111111111111111111111
100000000000000000000000000000001
100000000011110000000000000000001
1000000000001100000000N0000000001
111111000000000000000000000000001
111111111111100000011111111111111
10000000000000000000000000000001
10000000111000000000000000000001
10000000000001110000000000000001
11111111111111111111111111111111 