NO  ./spites/terre.xpm
S ./spites/sinje.xpm
WE ./spites/mur.xpm
EA ./spites/banana.xpm
F 255,255,255
C 255,255,0




111111111111111111111111111111
    1111   1111111111111   1111111111111111111111
111100001110000000000001111111
100100000000000000000000111111111
111111111011000001110000000000001
100000000011000001110111111111111
11110111111111011100000010001
11110111111111011101010010001
11000000110101011100000010001
1000000000000001100000010001
10000000000000001101010010001
11000001110101011111011110N0111
11110111 1110101 101111010001
11111111 1111111 111111111111


